16 16 16 16 16 16 16 16 16 16 16 16 16 16 16 16 16 16 16 16 16 16 16 16 16 16 16 16 16 16 16 16 16 16 16 16 16 16 16 16 16 16 16 16 16 16 16 16 16 16 
16 16 16 16 16 16 16 16 16 16 16 16 16 16 16 16 16 16 16 16 16 16 16 16 32 1 1 1 1 1 1 1 20 21 21 21 21 21 21 21 21 21 22 1 1 1 1 1 1 16 
3 3 3 16 16 16 16 16 16 16 3 3 3 3 3 3 3 3 3 3 3 3 3 3 32 1 1 1 1 33 1 1 23 19 19 19 19 19 19 19 19 19 24 1 1 1 1 1 1 16 
16 16 3 16 16 16 16 16 16 16 3 16 16 16 16 16 16 16 16 16 16 16 16 3 32 1 1 3 1 1 1 1 25 26 26 26 26 26 26 29 19 19 24 3 3 3 3 3 1 16 
16 16 3 3 3 3 16 16 16 3 3 16 16 16 16 16 16 16 16 16 16 16 16 3 32 1 1 3 1 1 1 3 3 3 3 3 3 3 3 25 26 26 27 3 1 1 1 3 1 16 
16 16 16 16 16 3 16 16 16 3 16 16 16 16 16 16 16 16 16 16 16 16 16 3 32 1 1 3 3 3 3 3 1 1 1 1 1 1 3 1 1 1 1 3 1 1 1 3 1 16 
16 16 16 16 16 3 16 3 3 3 3 16 16 16 16 16 16 16 16 16 16 16 16 3 32 1 1 1 3 1 1 3 1 33 1 1 33 1 3 1 1 1 1 3 1 1 1 3 1 16 
16 16 16 16 16 3 3 3 16 16 3 3 3 3 3 16 16 16 16 16 16 16 16 3 32 33 1 1 1 1 1 3 1 1 1 1 1 1 3 3 3 3 3 3 1 1 1 3 1 16 
16 16 16 16 16 16 16 16 16 16 16 16 16 16 3 3 16 16 16 16 16 16 16 3 32 1 1 3 3 3 3 3 3 3 3 1 1 1 3 1 20 21 21 21 21 22 1 3 1 16 
16 16 16 16 16 16 16 16 16 16 16 16 16 16 16 3 16 16 16 16 16 16 16 3 32 1 1 3 1 1 1 1 33 1 3 1 1 1 3 1 23 18 18 18 18 24 1 3 1 16 
16 16 16 16 3 3 3 3 3 3 16 16 16 16 16 3 16 16 16 16 16 16 16 3 32 1 1 3 1 1 33 1 1 1 3 1 33 1 3 1 23 18 18 18 18 24 1 1 1 16 
16 16 16 16 16 16 16 16 16 3 16 16 16 16 16 3 16 16 16 16 16 16 16 3 32 1 1 3 1 1 1 1 1 1 3 1 1 1 3 1 23 18 18 18 18 24 1 1 1 16 
16 16 16 16 16 16 16 16 16 3 16 16 16 16 16 3 3 3 3 16 16 16 16 3 32 1 1 3 3 3 1 1 1 1 3 1 1 1 3 1 25 26 26 26 26 27 1 1 1 16 
16 16 16 16 16 16 16 16 16 3 16 16 16 16 16 16 16 16 3 16 16 16 16 3 32 1 1 1 1 3 3 1 33 1 3 1 1 1 3 3 3 3 3 3 3 3 3 1 1 16 
16 16 16 16 3 3 3 3 3 3 3 3 3 3 3 3 3 3 3 16 16 16 16 3 32 1 1 1 33 1 3 1 33 1 1 1 1 1 1 1 1 1 1 1 1 1 3 1 1 16 
16 16 16 16 3 16 16 16 16 16 16 16 16 16 16 3 16 16 16 16 16 16 16 3 32 1 33 1 1 1 3 1 1 1 33 1 33 1 1 1 1 1 1 1 1 1 3 1 1 16 
16 16 16 16 3 3 3 3 3 3 3 3 3 3 3 3 16 16 16 16 16 16 16 3 32 1 1 1 1 1 3 1 1 1 1 1 1 1 1 33 1 1 33 1 33 1 3 1 1 16 
16 1 1 1 1 1 1 1 1 1 1 1 1 1 3 3 3 3 3 3 3 3 3 3 32 1 1 1 1 1 3 3 3 3 3 1 1 1 1 1 1 1 1 1 33 1 3 1 1 16 
16 1 20 21 21 21 21 21 21 21 21 21 22 1 3 1 1 1 1 1 1 1 1 1 32 1 1 1 1 1 1 1 1 1 3 3 3 1 1 1 1 1 1 1 1 1 3 1 1 16 
16 1 23 18 18 18 19 19 18 18 18 18 24 1 3 3 3 3 3 3 3 3 3 3 32 1 1 1 1 33 1 1 33 1 1 1 3 1 33 1 1 3 3 3 3 3 3 1 1 16 
16 1 23 18 18 18 19 18 18 19 18 18 24 1 3 16 20 21 21 21 21 21 22 3 32 1 1 1 3 3 3 3 1 1 1 1 3 1 1 1 1 3 1 1 1 1 1 1 1 16 
16 1 23 18 19 19 19 18 18 19 18 18 24 1 3 16 23 19 19 18 18 18 24 3 32 1 33 1 3 1 1 3 1 1 33 1 3 1 1 1 1 3 1 1 1 1 1 1 1 16 
16 1 25 26 26 26 26 26 26 26 26 26 27 1 3 16 23 18 19 19 19 19 24 3 32 1 1 1 3 1 1 3 1 1 1 1 3 1 33 1 1 3 32 32 32 32 4 5 6 16 
16 1 1 1 1 1 1 1 1 1 1 1 1 1 3 16 23 19 19 18 19 18 24 3 32 1 1 1 3 1 1 3 3 1 1 1 3 1 1 33 1 3 3 3 3 3 7 3 8 16 
16 1 3 1 3 3 3 3 3 3 3 3 3 3 3 16 23 18 19 19 18 19 24 3 32 1 1 1 3 1 1 1 3 3 3 3 3 1 1 1 1 3 32 32 32 32 9 10 11 16 
16 1 3 1 3 16 16 16 20 21 21 21 22 16 3 16 23 19 19 19 19 19 24 3 32 1 3 3 3 1 33 1 1 1 1 1 1 1 1 1 1 3 1 1 1 1 1 1 1 16 
16 1 3 1 3 16 16 16 23 19 18 19 24 16 3 16 23 19 18 18 19 18 24 3 32 1 3 1 1 1 1 1 1 1 1 1 1 33 1 33 1 3 1 20 21 21 21 22 1 16 
16 1 3 1 3 16 16 16 23 19 19 18 24 16 3 16 25 26 26 26 26 26 27 3 32 1 3 1 1 20 21 22 1 1 33 1 1 1 1 1 1 3 1 23 18 18 18 24 1 16 
16 1 3 1 3 16 16 16 25 26 26 26 27 16 3 3 3 3 3 3 3 3 3 3 32 1 3 1 1 23 18 24 1 1 1 3 3 3 3 3 3 3 1 23 18 18 18 24 1 16 
16 1 3 1 3 3 3 3 16 3 3 3 3 16 3 16 16 16 16 16 16 16 16 3 32 1 3 1 1 23 18 24 1 1 1 3 1 1 1 1 1 1 1 23 18 18 18 24 1 16 
16 1 3 1 1 1 1 3 16 16 16 16 3 16 3 16 20 21 21 21 21 22 16 3 32 1 3 3 3 25 26 27 1 1 1 3 3 1 1 1 1 1 1 25 26 26 26 27 1 16 
16 1 3 1 1 1 1 3 3 3 3 16 3 16 3 16 23 28 29 28 29 24 16 3 32 1 3 1 1 1 1 1 1 1 1 1 3 1 1 1 1 1 1 3 1 1 1 1 1 16 
16 1 3 3 1 1 1 1 1 1 3 16 3 16 3 16 23 30 31 30 31 24 16 3 32 1 3 1 33 1 1 1 33 1 1 1 3 3 3 3 3 3 3 3 1 1 1 1 1 16 
16 1 1 3 1 20 21 21 22 1 3 16 3 16 3 16 23 28 29 28 29 24 16 3 32 1 3 1 1 1 1 1 1 1 1 1 1 1 1 1 1 1 33 1 1 1 1 1 1 16 
16 1 1 3 1 23 19 19 24 1 3 16 3 16 3 16 23 30 31 30 31 24 16 3 32 1 3 3 3 3 1 1 1 1 1 1 1 1 1 1 1 1 1 1 3 1 1 1 1 16 
16 1 1 3 1 23 19 19 24 1 3 16 3 16 3 16 23 28 29 28 29 24 16 3 32 1 1 1 1 3 1 33 1 1 1 33 1 1 1 33 1 1 1 1 3 1 1 1 1 16 
16 1 1 3 1 25 26 26 27 1 3 16 3 16 3 16 23 30 31 30 31 24 16 3 32 1 33 1 1 3 1 1 1 1 1 1 1 33 1 1 1 33 1 1 3 3 3 3 1 16 
16 1 1 3 1 1 1 1 1 1 3 16 3 16 3 16 23 28 29 28 29 24 16 3 32 1 1 1 1 3 1 1 1 1 1 1 1 1 1 1 1 1 1 1 3 1 1 3 1 16 
16 1 1 3 1 1 3 3 3 3 3 3 3 16 3 16 23 30 31 30 31 24 16 3 32 1 33 1 1 3 3 3 3 3 3 3 3 3 3 3 3 3 3 3 3 1 1 3 1 16 
16 1 1 3 1 1 3 1 1 1 1 1 1 16 3 16 23 28 29 28 29 24 16 3 32 1 1 1 1 3 1 1 1 1 3 20 21 21 21 22 3 1 1 1 1 33 1 3 1 16 
16 1 1 3 1 1 3 1 20 21 21 21 22 16 3 16 23 30 31 30 31 24 16 3 32 1 33 1 1 3 1 33 1 33 3 23 18 18 18 24 3 1 1 33 1 1 1 3 1 16 
16 1 1 3 1 1 3 1 23 19 18 18 24 16 3 16 23 28 29 28 29 24 16 3 32 1 1 1 1 3 1 1 1 1 3 23 18 18 18 24 3 1 1 33 1 1 1 1 1 16 
16 1 1 3 1 1 3 1 23 19 19 18 24 16 3 16 23 30 31 30 31 24 16 3 32 1 33 1 1 3 1 1 33 1 3 23 18 18 18 24 3 1 33 1 1 33 33 1 1 16 
16 1 1 3 1 1 3 1 23 18 19 19 24 16 3 16 25 26 26 26 26 27 16 3 32 1 1 1 3 3 33 1 1 1 3 25 26 26 26 27 3 1 1 1 1 1 1 1 1 16 
16 1 3 3 3 3 3 1 23 19 18 18 24 16 3 16 16 16 16 16 16 16 16 3 32 1 1 1 3 1 1 1 1 3 3 3 3 3 1 1 3 3 3 1 3 3 3 1 1 16 
16 3 3 1 1 1 1 1 25 26 26 26 27 1 3 16 16 16 16 16 16 16 16 3 32 1 33 1 3 1 1 33 1 3 1 1 1 3 1 33 1 1 3 3 3 1 3 1 1 16 
16 3 3 1 1 1 1 1 1 1 1 1 1 1 3 16 16 3 3 3 3 3 3 3 32 1 1 1 3 1 1 33 1 3 1 1 1 3 1 1 1 1 1 1 1 1 3 1 1 16 
16 1 3 3 3 3 3 3 3 3 3 3 3 3 3 16 16 3 1 1 1 1 1 3 32 1 1 1 3 1 1 1 1 3 3 3 3 3 1 1 1 1 33 1 33 1 3 3 1 16 
16 1 1 1 1 1 1 1 1 1 1 1 1 1 3 3 3 3 3 3 3 3 3 3 3 3 3 3 3 1 1 1 1 1 1 1 1 1 1 1 1 1 1 1 1 1 1 1 1 16 
16 16 16 16 16 16 16 16 16 16 16 16 16 16 16 16 16 16 16 16 16 16 16 16 16 16 16 16 16 16 16 16 16 16 16 16 16 16 16 16 16 16 16 16 16 16 16 16 16 16 
