19 19 19 19 19 19 19 19 19 19 19 19 19 19 19 19 19 19 19 19 19 19 19 19 19 19 19 19 19 19 19 19 19 19 19 19 19 19 19 19 19 19 19 19 19 19 19 19 19 19 
19 19 19 19 19 19 19 19 19 19 19 19 19 19 19 19 19 19 19 19 19 19 19 19 20 1 2 1 1 1 1 34 35 35 35 35 35 35 35 35 35 35 36 1 1 1 1 1 1 19 
3 11 3 19 19 19 19 19 19 19 3 11 11 11 11 3 3 3 11 11 11 11 3 3 20 1 1 1 1 1 1 27 21 30 21 30 30 21 21 30 21 21 28 1 1 1 1 1 1 19 
19 19 3 19 19 19 19 19 19 19 3 19 19 19 19 19 19 19 19 19 19 19 19 3 20 1 1 3 1 2 1 22 23 23 23 23 23 23 23 33 21 30 28 3 3 11 11 3 1 19 
19 19 3 11 3 3 19 19 19 3 3 19 19 19 19 19 19 19 19 19 19 19 19 11 20 1 1 3 1 1 1 3 3 3 11 11 11 3 3 27 30 21 28 11 1 1 1 3 1 19 
19 19 19 19 19 3 19 19 19 11 19 19 19 19 19 19 19 19 19 19 19 19 19 11 20 1 1 3 11 11 3 11 1 1 1 1 1 1 3 27 21 30 28 11 1 1 1 11 1 19 
19 19 19 19 19 11 19 11 11 11 3 19 19 19 19 19 19 19 19 19 19 19 19 11 20 1 2 1 3 1 1 3 1 1 2 1 1 1 11 22 23 23 24 3 1 1 1 11 1 19 
19 19 19 19 19 3 11 11 19 19 11 11 11 11 3 19 19 19 19 19 19 19 19 11 20 1 1 1 1 1 1 3 1 1 1 1 1 1 11 3 3 11 3 3 1 1 1 11 1 19 
19 19 19 19 19 19 19 19 19 19 19 19 19 19 3 3 19 19 19 19 19 19 19 3 20 1 1 3 3 11 11 11 3 3 3 1 2 1 11 34 35 35 35 35 36 1 1 3 1 19 
19 19 19 19 19 19 19 19 19 19 19 19 19 19 19 3 19 19 19 19 19 19 19 3 20 1 1 3 1 1 1 1 1 1 3 1 1 1 3 27 21 30 30 21 28 1 1 3 1 19 
19 19 19 19 3 3 3 3 3 3 19 19 19 19 19 3 19 19 19 19 19 19 19 11 20 1 1 3 1 1 1 1 1 1 11 1 1 1 3 27 21 30 21 30 28 1 1 1 1 19 
19 19 19 19 19 19 19 19 19 11 19 19 19 19 19 3 19 19 19 19 19 19 19 11 20 1 2 11 1 1 2 2 1 1 11 1 1 2 3 27 30 21 21 30 28 1 1 1 1 19 
19 19 19 19 19 19 19 19 19 11 19 19 19 19 19 3 11 11 11 19 19 19 19 11 20 1 1 11 3 3 1 1 1 1 3 1 1 1 3 22 23 23 23 23 24 1 1 1 1 19 
19 19 19 19 19 19 19 19 19 11 19 19 19 19 19 19 19 19 3 19 19 19 19 11 20 1 1 1 1 3 11 1 2 1 3 1 1 1 3 3 11 3 3 11 11 3 3 1 1 19 
19 19 19 19 11 11 11 3 3 11 11 3 3 3 3 11 3 3 3 19 19 19 19 11 20 1 1 1 1 1 11 1 1 1 1 1 1 1 1 1 1 1 1 1 1 1 3 1 1 19 
19 19 19 19 11 19 19 19 19 19 19 19 19 19 19 11 19 19 19 19 19 19 19 3 20 1 1 2 1 1 11 1 1 2 1 1 2 1 1 2 1 1 1 1 1 1 11 1 1 19 
19 19 19 19 11 3 3 3 3 3 3 3 3 3 3 11 19 19 19 19 19 19 19 3 20 1 1 1 1 1 3 1 1 1 1 1 1 1 1 1 1 2 1 2 1 1 11 1 1 19 
19 1 1 1 1 1 1 1 1 1 1 1 1 1 11 3 3 11 11 11 11 11 3 3 20 1 1 2 1 1 3 11 11 11 3 1 1 1 1 1 1 1 1 1 1 1 11 1 1 19 
19 1 34 35 35 35 35 35 35 35 35 35 36 1 3 1 1 1 1 1 1 1 1 1 20 1 1 1 1 1 1 2 1 1 3 3 3 1 1 1 1 1 1 1 1 1 3 1 1 19 
19 1 27 21 30 21 21 21 21 21 30 21 28 1 3 11 11 11 3 3 3 3 3 3 20 1 1 1 1 1 1 1 1 1 1 1 11 1 1 1 1 3 3 11 11 11 3 1 1 19 
19 1 27 21 21 29 29 29 21 31 21 21 28 1 11 19 34 35 35 35 35 35 36 11 20 1 2 1 3 3 3 3 1 1 1 2 3 1 2 1 1 11 1 1 1 1 1 1 1 19 
19 1 27 21 29 21 29 21 30 21 21 21 28 1 11 19 27 29 21 21 21 21 28 11 20 1 1 1 11 1 1 11 1 2 1 1 11 1 1 1 1 11 1 1 1 1 16 17 18 19 
19 1 22 23 23 23 23 23 23 23 23 23 24 1 11 19 27 21 30 21 29 21 28 11 20 1 1 1 11 1 1 11 1 1 1 1 3 1 2 1 1 3 20 20 20 20 9 3 10 19 
19 1 1 1 1 1 1 1 1 1 1 1 1 1 3 19 27 21 30 29 29 21 28 11 20 1 2 1 11 1 1 11 3 1 1 1 3 1 1 1 1 3 0 0 0 0 3 3 10 19 
19 1 3 1 11 11 11 11 3 3 11 11 11 11 3 19 27 21 29 21 30 21 28 3 20 1 1 1 3 1 1 1 3 11 3 3 11 1 1 1 1 3 20 20 20 20 9 3 10 19 
19 1 11 1 3 19 19 19 34 35 35 35 36 19 3 19 27 21 31 21 29 29 28 11 20 1 3 3 3 1 2 1 1 1 1 1 1 2 1 1 1 11 1 1 1 1 4 5 6 19 
19 1 11 1 11 19 19 19 27 21 30 21 28 19 3 19 27 29 21 29 21 21 28 11 20 1 11 1 1 1 1 1 1 2 1 1 1 1 1 2 1 11 1 34 35 35 35 36 1 19 
19 1 3 1 11 19 19 19 27 30 21 30 28 19 3 19 22 23 23 23 23 23 24 11 20 1 11 1 1 34 35 36 1 1 1 2 1 1 1 1 1 11 1 27 21 30 21 28 1 19 
19 1 3 1 3 19 19 19 22 23 23 23 24 19 11 11 3 3 3 3 3 3 3 3 20 1 11 1 1 27 21 28 1 1 1 11 11 11 11 3 3 3 1 27 21 30 30 28 1 19 
19 1 3 1 3 3 3 11 19 3 3 3 3 19 3 19 19 19 19 19 19 19 19 3 20 1 11 1 1 27 21 28 1 1 1 3 1 1 1 1 1 1 1 27 30 21 30 28 1 19 
19 1 11 1 1 1 1 11 19 19 19 19 11 19 3 19 34 35 35 35 35 36 19 3 20 1 3 3 11 22 23 24 1 2 1 11 11 1 1 1 1 1 1 22 23 23 23 24 1 19 
19 1 11 1 1 1 1 3 3 3 3 19 11 19 3 19 27 32 33 32 33 28 19 11 20 1 3 1 1 1 1 1 1 1 1 1 3 1 1 1 1 1 1 11 1 1 1 1 1 1 
19 1 11 11 1 1 1 1 1 1 3 19 11 19 11 19 27 25 26 25 26 28 19 11 20 1 11 1 1 1 1 1 1 1 1 1 3 3 11 11 11 3 3 11 1 1 2 1 1 19 
19 1 1 3 1 34 35 35 36 1 11 19 3 19 11 19 27 21 21 21 21 28 19 11 20 1 3 1 1 1 1 1 2 1 1 1 1 1 1 1 1 1 1 1 1 1 1 1 1 19 
19 1 1 3 1 27 21 21 28 1 11 19 3 19 11 19 27 29 29 21 29 28 19 3 20 1 3 11 11 11 1 1 1 1 2 1 1 1 2 1 2 1 1 1 11 1 1 2 1 19 
19 1 1 3 1 27 21 21 28 1 3 19 3 19 3 19 27 29 21 31 21 28 19 3 20 1 1 1 1 3 1 1 1 1 1 1 1 1 1 1 1 1 2 1 11 1 1 1 1 19 
19 1 1 3 1 22 23 23 24 1 3 19 3 19 11 19 27 21 21 30 21 28 19 11 20 1 2 1 1 3 1 1 2 1 1 1 2 1 1 1 2 1 1 1 11 3 3 3 1 19 
19 1 1 11 1 1 1 1 1 1 3 19 3 19 11 19 27 21 21 30 21 28 19 11 20 1 1 1 1 3 1 1 1 1 1 1 1 1 1 1 1 1 1 1 3 1 1 11 1 19 
19 1 1 11 1 1 11 11 11 11 3 3 3 19 11 19 27 21 29 21 21 28 19 3 20 1 2 1 1 3 3 11 11 11 3 11 11 11 3 3 11 3 3 11 3 1 1 11 1 19 
19 1 1 11 1 1 3 1 1 1 1 1 1 19 11 19 27 29 29 21 31 28 19 3 20 1 1 1 1 11 1 1 1 1 3 34 35 35 35 36 11 1 1 1 1 1 1 11 1 19 
19 1 1 11 1 1 3 1 34 35 35 35 36 19 3 19 27 21 21 21 21 28 19 11 20 1 1 1 2 11 1 2 1 1 3 27 30 21 30 28 11 1 2 1 1 2 1 3 1 19 
19 1 1 3 1 1 11 1 27 21 21 30 28 19 3 19 27 32 33 32 33 28 19 11 20 1 2 1 1 11 1 1 1 2 11 27 21 21 30 28 11 1 1 1 1 1 1 1 1 19 
19 1 1 3 1 1 11 1 27 30 21 21 28 19 3 19 27 25 26 25 26 28 19 11 20 1 1 1 1 3 1 2 1 1 11 27 30 30 21 28 3 1 2 1 1 2 1 1 1 19 
19 1 1 3 1 1 11 1 27 21 30 21 28 19 11 19 22 23 23 23 23 24 19 3 20 1 2 1 3 3 1 1 1 1 3 22 23 23 23 24 3 1 1 1 1 1 1 1 1 19 
19 1 11 11 11 3 3 1 27 30 21 30 28 19 11 19 19 19 19 19 19 19 19 3 20 1 1 1 11 1 1 1 1 3 3 11 11 11 1 1 3 11 11 1 11 11 3 1 1 19 
19 3 11 1 1 1 1 1 22 23 23 23 24 1 11 19 19 19 19 19 19 19 19 11 20 1 1 1 11 1 2 1 1 3 1 1 1 3 1 1 1 1 3 3 3 1 3 1 1 19 
19 3 3 1 1 1 1 1 1 1 1 1 1 1 3 19 19 3 3 3 11 3 3 11 20 1 2 1 11 1 1 1 1 3 1 1 1 3 1 1 1 1 1 1 1 1 3 1 1 19 
19 1 11 11 11 11 3 3 3 11 11 11 3 3 3 19 19 3 1 1 1 1 1 3 20 1 1 1 3 1 2 1 1 3 11 11 11 3 1 2 1 1 2 1 1 1 11 11 1 19 
19 1 1 1 1 1 1 1 1 1 1 1 1 1 3 3 11 11 11 11 3 3 3 11 11 11 11 3 3 1 1 1 1 1 1 1 1 1 1 1 1 1 1 1 1 1 1 1 1 19 
19 19 19 19 19 19 19 19 19 19 19 19 19 19 19 19 19 19 19 19 19 19 19 19 19 19 19 19 19 19 19 19 19 19 19 19 19 19 19 19 19 19 19 19 19 19 19 19 19 19 
